#.##....#...........#.........
..#.......#.#.....##....##..#.
.......##.......#...##...#....
...##.#.....#..#...##..#......
#.#.....#.#..#..............#.
.......#....#.....#..#........
.....#...#.................#..
.#...###...#...#.#..#.......#.
....................#........#
......#..#..####....##..#.##..
......#........#.......#......
....#.....##.##....#.#..#.##.#
S.#....#..........##...........
..#....#...#........#.......##
.#...#.##..#.#..............##
