#..##.#.#.#..#.#...##......###
#.#...##..###..#.....#.....#.#
..#....#.......#.#.#.#......#.
#..#.....###.....#...#..#..#.#
#####..#.......#......#....#..
....#..###.#...##..###..#..##.
#...#.#............####.....#.
#..#...#..#.#..####.#.#...#.#.
####.#.....#.....###.###....#.
#...#..#...###.#.#.........#..
....##...#.##.##.......#.#.#..
#.....#..##..#.##.#..#....##..
.#.#..#..##.#...#....#...#....
.#.#..#..#............##.#.#..
........#..........#.#.....#..
.....#....#.#...S...##.#..##.#
..#..#.#......#......#....#...
#..#.##.#......#..#...#.#.#...
.#.#..##...#.#..#......#..##..
#.#.##.#.#..###....###........
#..#.###.##...###..#..#..#.#..
.###...#...#####.##.......###.
.#....#...#....#...#.......##.
##.#..#.#.##.......#.#.##..#..
#..##....##..#...##.........##
..#....####..#.....##.........
....#...##..#.##..#.####.#..#.
##..#..#....#..#..####..E#..##
####...#...#.#.##.#..#......#.
.#....#.##....##..##.#..#....#
