#.#.#.......#.....#.#..#......
.##.E..##.#..#..#....#......#.
...##..#.#..##......#...#...#.
.#.#......S.#.....#....#...#..
..#####.##.......####..##.....
.#.....#..#....#..##.##.......
.#....#.#...##.##.....#.##.#..
..#...##......#.....#.........
...##...#..##.##.###...#..##.#
...#...#..#..##.##..###.#....#
..#..#..#..##.#.....#.#.#.#...
..##....#.##..#..#.#....#.....
.#.##.#...#.##.##...#.......#.
#.#.....##...##.....##..##.#.#
#.##...#.###.#...##.##...#..##
#.#...##.###..#..#.#..#..##..#
#...##.#.####...###..##.....#.
.#.....###.#..##.#......#.#...
...........##..#...#.##.......
.....#.#...###..##.####..###.#
...##......#......#..#.##...#.
.##........#..#...#..#....#.##
.........##..#.#....#.......#.
..###....#..#..#..##.#.#...#..
.#....#...#.......#......#..#.
..#...#.....##...##.##.#.....#
...........##..###.#.#.....#..
#........#..#.....#..#.#.....#
.###..##..#.#....#...##..##.#.
.....####..######.#...#.#..#.#
